0000100003
11111001100111114
11011101010111010101110115
11011100010000000000000005
11111010010000000000000005
00000010011111101001000005
11011010100000000000000005
10101101010000000000000005
00000101011010110101000005
00001000110001101111111105
11000110011111101001000005
11111000011110001000000005