000010000
1111100110011111
1101110101011101010111011
1101110001000000000000000
1111101001000000000000000
0000001001111110100100000
1101101010000000000000000
1010110101000000000000000
0000010101101011010100000
0000100011000110111111110
1100011001111110100100000
1111100001111000100000000