0000100003
11111001100111114
11011101010111010101110115
11011100010000000000000005
11111010010000000000000005
00000010011111101001000005
11011010100000000000000005
10101101010000000000000005
00000101011010110101000005
00001000110001101111111105
11000110011111101001000005
11111000011110001000000005
10001010100101000000000005
00000100010111000000000005
00100001001101100100001005
01010110110000011011010105
01010010100000001010010105
00100000001010100000001005
01110111110000000000000005
11111011100101000000000005
01010111110111011111010105
10000010000010000010000015
00000000010001000101010115
00001000110001001110110005
00000010000000001010000005
00000000001010100000000005
00000110110000010001110115
01010100010000011011100015
10101101010000010101101015
11011000001101100000110115
11111010100010001010111115
01010110111101111011010105
11110111011110100011110115
00000101010000000000101015
11111111110000011111111115
00001000110001001100110005
10001111111010111011001005
00000100011101100000000005
00100100011111110001001005
10001010101101101010100015
00100011001101100110001005
11111001000000000100111115
11111101010101010101111115
00000101011000110101100015
00000000000111001000000005
00001000100010001100101005
00000001000101010101010105
00000000001010110101011105
01110011100111000000000005
11110100011000110001111105
10101100011101110001101015
01010111110111001011111005
01010111111010111111010105
00000001001101100100000005
10101100010111010001101015
11111001001000100100111115
00010001010101010100010005
10001000000000000000100015
10000000000000000000000015
00000000000100001000010005
10001010100000001010100015
01110010100111000010011105
11110100101111011100100105
00000010100111001010000005
10101101011010110101011105
11111010101101101110010105
11111011100111001110111115
10001010100010000000000005
11111000110000100001000015
01000111001111100111000105
00100011101101101110001005
00000001001111100100000005
00000010000000001000000005
10001100010000010001100015
11111010100010001010101015
10101000001010100000101015
10001010100101001010100015
00000000001000100000000005
10101000000000000000101015
10000100001000010000111115
00000000000010001110111115
00100010101010101010001005
01110010000111000010011105
01010101010111010101010105
11111100011010110001111115
00000101010000010101000005
10101001000000000000000005
00010001010101010101010115
00100100011010110001001005
10001110111010110001100015
10001000001010100000100015
01000101000100000000000005
00100000001000100000001005
10101000001000100000101015
00000000000011100110001005
00000000001000111111010015
01111010000111001000010005
01110100011000110001011105
00000010000000000010000005
10101010100010001010101015