0000100003
11111001100111114
11011101010111010101110115
11011100010000000000000005
11111010010000000000000005
00000010011111101001000005
11011010100000000000000005
10101101010000000000000005
00000101011010110101000005
00001000110001101111111105
11000110011111101001000005
11111000011110001000000005
10001010100101000000000005
00000100010111000000000005
00100001001101100100001005
01010110110000011011010105
01010010100000001010010105
11011101010111010101110115
00100000001010100000001005
01110111110000000000000005
11111011100101000000000005
01010111110111011111010105
10000010000010000010000015
00000000010001000101010115
00001000110001001110110005
00000010000000001010000005
00000000001010100000000005
00000110110000010001110115
01010100010000011011100015
10101101010000010101101015
11011000001101100000110115
11111010100010001010111115
01010110111101111011010105
11110111011110100011110115
00000101010000000000101015
11111111110000011111111115
00001000110001001100110005
10001111111010111011001005
00000100011101100000000005
00100100011111110001001005